-----------------------------------------
-----------------------------------------
-----------------------------------------
****************************************-
*--------------------------------------*-
*--------------------------------------*-
*--------------------------------------*-
*--------------------------------------*-
*--------------------------------------*-
*--------------------------------------*-
*----******************************----*-
*--------------------------------------*-
*--------------------------------------*-
*--------------------------------------*-
*--------------------------------------*-
*--------------------------------------*-
*--------------------------------------*-
*----******************************----*-
*--------------------------------------*-
*--------------------------------------*-
*--------------------------------------*-
*--------------------------------------*-
*--------------------------------------*-
*--------------------------------------*-
****************************************-
-----------------------------------------