-----------------------------------------
-----------------------------------------
-----------------------------------------
****************************************-
*--------------------------------------*-
*--------------------------------------*-
*--------------------*-----------------*-
*--------------------*-----------------*-
*--------------------*-----------------*-
*--------------------*-----------------*-
*--------------------*-----------------*-
*--------------------------------------*-
*--------------------------------------*-
*----******************************----*-
*--------------------------------------*-
*--------------------------------------*-
*-----------------*--------------------*-
*-----------------*--------------------*-
*-----------------*--------------------*-
*-----------------*--------------------*-
*-----------------*--------------------*-
*--------------------------------------*-
*--------------------------------------*-
*--------------------------------------*-
****************************************-
-----------------------------------------