-----------------------------------------
-----------------------------------------
-----------------------------------------
******************----******************-
*----------------*----*----------------*-
*----------------*----*----------------*-
*--------------------------------------*-
*--------------------------------------*-
*--------------------------------------*-
*--------------------------------------*-
*--------------------------------------*-
***--------------*----*--------------***-
-----------------------------------------
-----------------------------------------
-----------------------------------------
***--------------*----*--------------***-
*--------------------------------------*-
*--------------------------------------*-
*--------------------------------------*-
*--------------------------------------*-
*--------------------------------------*-
*--------------------------------------*-
*----------------*----*----------------*-
*----------------*----*----------------*-
******************----******************-
-----------------------------------------