-----------------------------------------
-----------------------------------------
-----------------------------------------
-----------------------------------------
--***------------------------------------
-*---------------------------------------
--**-------------------------------------
----*------------------------------------
-***-------------------------------------
------*---*------------------------------
------**--*------------------------------
------*-*-*------------------------------
------*--**-----------------****---------
------*---*----*------------*------------
--------------*-*-----------****---------
-------------*---*----------*------------
-------------*****---*--*---****---------
-------------*---*---*-*-----------------
---------------------**------------------
---------------------*-*-----------------
---------------------*--*----------------
-----------------------------------------
-----------------------------------------
-----------------------------------------
-----------------------------------------