-----------------------------------------
-----------------------------------------
-----------------------------------------
****************************************-
*--------------------------------------*-
*--------------------------------------*-
*---********************************---*-
*---*------------------------------*---*-
*---*------------------------------*---*-
*---*---**********-----*********---*---*-
*---*---*----------------------*---*---*-
*---*---*----------------------*---*---*-
*---*---*----------------------*---*---*-
*-------*-------*********------*-------*-
*-------*-------*********------*-------*-
*---*---*----------------------*---*---*-
*---*---*----------------------*---*---*-
*---*---*----------------------*---*---*-
*---*---**********-----*********---*---*-
*---*------------------------------*---*-
*---*------------------------------*---*-
*---********************************---*-
*--------------------------------------*-
*--------------------------------------*-
****************************************-
-----------------------------------------